70,70,69,69,69,70,70,70,70,69,69,70,70,70,70,70,69,70,70,
70,69,70,69,70,70,69,69,70,70,70,69,69,70,70,69,70,69,70,
70,70,70,70,69,69,70,70,70,70,69,70,70,69,69,69,70,69,69,
70,70,70,69,70,70,69,69,69,70,69,69,70,70,70,69,70,70,70,
69,70,70,70,69,70,70,70,70,70,69,70,69,70,69,70,70,70,69,
70,70,69,70,69,70,69,69,70,70,70,70,70,69,70,69,69,70,70,
69,69,70,70,69,70,69,70,70,70,70,70,69,69,70,69,70,70,70,
69,70,70,70,70,70,69,70,69,69,70,70,70,69,69,70,70,70,70,
70,70,69,70,69,70,70,69,70,69,70,69,70,70,70,70,69,69,70,
70,70,70,69,70,70,69,70,70,69,70,70,69,70,70,70,69,70,70,
70,70,70,70,70,69,69,69,70,70,69,70,70,69,69,70,69,70,69,
70,70,70,70,69,69,70,70,70,69,70,69,70,70,70,69,69,70,70,
69,69,69,70,69,69,70,70,70,70,70,70,70,70,70,69,69,70,70,
69,70,69,70,69,69,70,70,69,70,70,70,70,69,70,69,69,70,70,
70,70,70,70,70,70,70,69,69,70,70,70,69,69,70,70,70,70,69,
70,70,70,70,69,70,70,69,70,70,70,70,70,69,70,69,70,69,70,
70,70,70,70,70,70,70,70,70,69,70,69,70,70,69,70,70,70,69,
69,69,70,70,69,70,69,70,70,69,70,69,70,70,69,69,70,70,70,
70,69,70,70,70,69,70,70,70,70,70,70,69,70,70,70,70,70,70,